#Général
Delete=Supprimer
Save=Sauvegarder
Settings=Réglages
Setup=Installation
Enabled=Activé

#Akku Trips.json
Akku Trips=Consommation de la batterie (conduite)
Start Trip=Départ du trajet
End Trip=Fin du trajet
Time=Date
StartSOC=EDC Début
EndSOC=EDC Fin
SOC diff=EDC diff 
Start km=Début km
End km=Fin km
Start mi=Début mi
End mi=Fin mi
kmDiff=km Diff
Max Range=Autonomie max
Ø Verbrauch=Consommations moy.
Tage=Jours

#Degradation.json
Degradation=Dégradation
Maximalreichweite [km]=Autonomie Max [km]
Maximalreichweite [mi]=Autonomie Max [mi]
km Stand [km]=Kilométrage [km]
mi Stand [mi]=Millage [mi]
Odometer [mi]=Odomètre [mi]
Max. Reichweite (Monatsmittel) [km]=Autonomie Max (mensuelle) [km]
Max. Reichweite (Monatsmittel) [mi]=Autonomie Max (mensuelle) [mi]

#Ladehistorie.json
Ladehistorie=Historique des recharges
Startdatum=Date de début
Enddatum=Date de fin
geladen kWh=Chargé kWh
km Stand=Odomètre
Adresse=Adresse
TR km Start=TR Début km
TR km Ende=TR Fin km
SOC Ende=Fin SOC
100% TR=100% TR
Minuten=Minutes
TR mi Start=TR mi Début
TR mi Ende=TR mi Fin
ØkW=kW moy.

#Ladestatistik.json
Ladestatistik=Statistiques des recharges
Letzte Ladung=Dernière recharge
Ort=Adresse
Ø geladen kWh=Recharge moy. [kWh]
Ladezeit h=Durée de la recharge [h]
Ø SOC=EDC moy.
Max SOC=EDC max
Anzahl Ladungen=Coût de la Recharge
Anzahl=Coût
Geladen=Chargé
Ladezeit=Durée
Anz. Ladungen=No de recharge
Ladehub=% de Recharge
PV=Solaire

#SOC Ladestatistik.json
SOC Ladestatistik=Statistisques des recharges
SOC [%]=EDC [%]

#SOC Entladestatistik.json
SOC Entladestatistik=Statistiques des décharges

#Laden.json
Laden=Recharge
Ladespannung [V]=Voltage [V]
Reichweite [mi]=Autonomie [mi]
Reichweite [km]=Autonomie [km]
Leistung [kW]=Puissance [kW]
Phasen=Phases
Stromstärke [A]=Intensité [A]
Angefordert [A]=Demandé [A]
Pilot [A]=Pilote [A]

#Vampir Drain Monatsstatistik.json
Vampir Drain Monatsstatistik=Statistiques mensuelles des Consommations "Vampire"
TR mi Verlust=TR mi perdu
kWh Verlust=kWh perdu
Eur Verlust=Euro perdu

#Trip.json
Trip=Trajets
Start=Départ
Ende=Fin
Start Adresse=Adresse départ
Ziel Adresse=Adresse destination
Ø Verbrauch kWh=Consommations moy. [kWh]
Verbraucht kWh=Consommée [kWh]
Dauer Min=Durée Min
mi=mi
km=km
Ø °C=°C moy.
Ø °F=°F moy.
max mph=mi/h max
max km/h=km/h max
max PS=HP max
min PS=HP min
max kW=kW max
min kW=kW min
Ø PS=HP moy.
Ø kW=kW moy.
Ø mph=mi/h moy.
Ø km/h=km/h moy.

#Vampir Drain Monatsstatistik.json
Zeitspanne Stunden=Durée heure
TR mi Verlust pro Stunde=TR mi perdu par heure
mi Stand=Odomètre

#Vampir Drain.json
Vampir Drain=Consommations "Vampires"
Standby Stunden=Heures de veille
Standby=En Veille
TR km Verlust=TR km Perdu
TR km Verlust pro Stunde=TR Km perdu par heure

#Verbrauch.json
Verbrauch=Consommations
Höhe [m]=Altitude [m]
Altitude [m]=Altitude [m]
Geschwindigkeit [mph]=Vitesse [mi/h]
Geschwindigkeit [km/h]=Vitesse [km/h]
Leistung [PS]=Puissance [HP]
Außentemperatur [°C]=Température extérieure [°C]
Außentemperatur [°F]=Température extérieure [°F]
Innentemperatur [°C]=Température intérieure [°C]
Innentemperatur [°F]=Température intérieure [°F]

Laden fertig=Recharge terminée
Schlafen=Sommeil
Online=En ligne

#Verbrauchsstatistik.json
Verbrauchsstatistik=Stastistiques de consommation

#Visited.json
Visited=Lieux

#index.php
Car Info=Information sur la voiture
Status=Status
Typical Range=Autonomie typique
Odometer=Odomètre
Car Version=Version logiciel
Last Trip=Dernier trajet
Duration=Durée
Distance=Distance
Max kph=Max km/h
PS=PS
Current Pos=Position actuelle
Last Update=Dernière mise à jour
Charging=Recharge
Done=Fait
Done at=Fait à
Battery Heater=Température batterie
Sentry Mode=Mode Sentinelle
Preconditioning=Préconditionnement
Offline=Hors ligne
Falling asleep=Endormie

#menu.php
Logfile=Logfile
Restart=Redémarrer
Update=Mise à jour
Dashboards=Tableaux de bord
Fleet Statistic=Statistiques de la flotte
Extras=Extras
Restore=Restauration
Geofence=Géorepérage
Suspend Teslalogger=Suspendre Teslalogger
Wakeup Teslalogger=Activer Teslalogger
Dashboard=Tableaux de bord

#password.php
Set password for Teslalogger's admin panel=Définir un mot de passe pour l'administrateur Teslalogger
Teslalogger Tesla Credentials=Identifiants Tesla
Please enter your Tesla account credentials=Veuillez saisir les informations d'identification de votre compte Tesla
Email=Email
Password=Mot de passe
Repeat Password=Répéter le mot de passe
Löschen=Effacer
Speichern=Sauvergarder

#settings.php
MyTesla=Voiture Tesla
Please choose your vehicle=Veuillez sélectionner un véhicule
Teslalogger Adminpanel=Administrateur Teslalogger
Credentials=Identifiants
Language=Langue
Power=Puissance
Temperatur=Température
Unit of length=Unité de longueur
mile=mille
Range=Autonomie
Ideal=Idéal
Rated=Évaluée
Share data anonymously=Partager les données de façon anonyme
Automatic updates=Mise à jour automatique
Sleep:Mettre Teslalogger en veille
URL Admin Panel=URL panneau d'administration
All=Tous
Stable=Stable
None=Refuser
Enable=Autoriser
Celsius=Celsius
Fahrenheit=Fahrenheit
URL Grafana=URL Grafana
Teslalogger HTTP Port=Port HTTP Teslalogger
Zoom Level=Niveau de zoom
ScanMyTesla integration=Intégrer ScanMyTesla
Main Car=Voiture principale
Car Name=Nom de la voiture
ScanMyTesla last received=ScanMyTesla reçu pour la dernière fois
Tasker Token=Clé Tasker
Tasker URL=URL Tasker
Received Tasker Token=Clé Tasker reçue
Show calc. 100% range=Afficher l'autonomie calculée (100%) 

#geoadd.php
Bezeichnung=Description

#Alle Verbräuche - ScanMyTesla.json
Alle Verbräuche - ScanMyTesla=Toutes les consommations - ScanMyTesla
Zelltemperatur [°C]=Température de la cellule [°C]
Zelltemperatur [°F]=Température de la cellule [°F]

#Trip Monatsstatistik.json
Datum=Date
Fahrzeit [h]=Durée Conduite [h]
Strecke [km]=Distance [km]
Strecke [mi]=Distance [mi]
Verbraucht [kWh]=Consommations [kWh]
Ø Verbrauch [kWh]=Consommations moy. [kWh]
Anzahl Trips=Nb de trajet
Trip Monatsstatistik=Statistiques des trajets mensuels
Jahr/Monat=Année/Mois

Zellspannungen 01-20 - ScanMyTesla=Tension des cellules 01-20 - ScanMyTesla
Zellspannungen 21-40 - ScanMyTesla=Tension des cellules 21-40 - ScanMyTesla
Zellspannungen 41-60 - ScanMyTesla=Tension des cellules 41-60 - ScanMyTesla
Zellspannungen 61-80 - ScanMyTesla=Tension des cellules 61-80 - ScanMyTesla
Zellspannungen 81-99 - ScanMyTesla=Tension des cellules 81-99 - ScanMyTesla

Zellspannungen=Tension des cellules
Zellspannung=Tension de cellule

Ja=Oui
Nein=Non

Einschlafen=Sommeil

TextShare=<h1>Partager les courbes de charge / courbes de dégradation de manière anonyme</h1>Nous souhaitons créer une base de données anonyme pour comparer les courbes de dégradation et les courbes de charge. Cela vous permet de comparer votre véhicule avec d'autres à tout moment et de détecter à un stade précoce tout écart inhabituel. Cela peut également être utilisé pour démontrer la pleine efficacité de la batterie lors de la vente du véhicule. Dans le cas contraire, vous pouvez plus facilement prouver une performance réduite face à Tesla Motors.<br><br>Souhaitez-vous partager vos courbes de charge rapide et vos courbes de dégradation avec d'autres conducteurs Tesla de manière totalement anonyme ? Cette décision peut être modifiée à tout moment dans l'écran des paramètres.
Daten anonym teilen=Partage des données de manière anonyme
TextSuspendTeslalogger=Teslalogger a été arrêté ! Les données ne seront pas enregistrées !
Resume Teslalogger=Reprendre Teslalogger

#Timeline Plugin.json
Parking=Stationnement
Driving=Conduite
Charging=Recharge
Missing=Perdue
Ø Temperatur=Température moy.
Verbraucht=Consommation

Position by StreamingAPI=Position par StreamingAPI
StreamingPosHelp=<h1>Position par StreamingAPI</h1>Utilise StreamingAPI pour sauvegarder la position de la voiture dans la base de données Teslalogger. Selon la réception de la voiture, cela signifie jusqu'à 5 positions par seconde(comparé à une position toutes les cinq secondes en mode normal). Cela augmentera beaucoup la taille de votre base de données, augmentera l'usure de la carte SD et entraînera d'énormes sauvegardes.

TeslaAuthApps=Vous pouvez utiliser les applications suivantes pour obtenir un accès et une actualisation du serveur Tesla:

#journeys.php
Ladezeit [h]=Temps de recharge [h]

#Status.json
Current Status=Status actuel
SOC=EDC
Reichweite=Autonomie
Außentemperatur=Température extérieur
Zelltemperatur=Température des cellules
Nur verfügbar mit ScanMyTesla=Disponible seulement avec ScanMyTesla

#abrp.php
ABRPTitle=Un meilleur lien planificateur d'itinéraire
TextABRP=Vous pouvez configurer un lien de Teslalogger vers Abetterrouteplanner pour éviter de donner vos informations d'identification Tesla à un tiers. Un autre avantage est de minimiser le nombre de réveil de la voiture si plus d'un service utilise vos informations d'identification.
ABRP1=Créer un compte Abetterrouteplanner
ABRP2=Aller aux paramètres
ABRP3=Choisissez votre voiture
ABRP4=Enregistrer votre voiture sur votre compte
ABRP5=Donnez un nom à votre voiture
ABRP6=Cliquez sur "Lien générique" pour obtenir un jeton ABRP
ABRP7=Copiez le jeton et cliquez sur "Terminé"
ABRP8=Insérer le jeton dans Teslalogger
ABRP9=Vérifier si Teslalogger est connecté
ABRPYT=Consultez le didacticiel YouTube pour une démonstration en direct
ABRPToken=Jeton Abetterrouteplanner

#chargingcost.php
Charging Costs=Coût recharges
Charger=Station de recharge
Charged=Chargé
Date=Date
Minutes=Minutes
Efficiency=Efficacité
Currency=Argent
kWh according to meter/invoice=kWh selon compteur/facture d'achat
Cost per kWh=Prix du kWh
Cost per charge=Coût par recharge
Cost per minute=Coût par minute
Idle cost per minute=Coût d'inactivité par minute
Total=Total
